1111111771111111
1.....222......1
1....22....1...1
1.....222......1
1.11...22......1
1..1....22.....1
1........222...1
02222.....222228
022222.....222.8
1...222........1
1....222.......1
1..1...22..1...1
1..1...22......1
1.....22.......1
1......22......1
1111111991111111
