1111111771111111
1.......2......1
1..............1
1......2.......1
1..............1
1.....2........1
1..............1
0...2...2.....21
0.2..........221
1.......2..2..21
1.....2........1
1.....2........1
1.....2........1
1......222222221
1111111111111111
