1111111111111111
1..............1
1..............1
1..............1
1..............1
1..............1
1..............1
1.....2........8
1....2....2....8
1......2....2..1
1.......2......1
1......2.......1
1......2.......1
1.....2........1
1......2.......1
1111119911111111
