1111111111111111
1..............1
1..2...........1
1..22....11....1
1.......11.....1
1....2.........1
1....22........1
1..1..2222222..8
1.......22222..8
1..............1
1..22....11....1
1...22....11...1
1...22.........1
1....22.222....1
1..............1
1111111111111111
