1111111111111111
1000000000000001
1002000000000001
1002200001100001
1000000011000001
1000020000000001
1000022000000001
1001002222222008
1000000022222008
1000000000000001
1002200001100001
1000220000110001
1000220000000001
1000022022200001
1000000000000001
1111111111111111
