1111111111111111
1......2.......1
1.........2....1
1.....1...22...1
1.....1..22....1
1.....1..22....1
1.....1...22...1
0.....111..2...8
0.2.....1......8
1..2....1......1
1..2.....1.....1
1...2.....1....1
1.....2....1..11
1.......22...1.1
1..............1
1111111111111111
