1111117711111111
1.....22.......1
1.....222...1..1
1......222.....1
1..11...22.....1
1..11..22..1...1
1.....22.......1
1....2222222...8
1......2222222.8
1.......2......1
1..11..........1
1......22......1
1.......2.1....1
1....2.........1
1..............1
1111111111111111
