1111117711111111
1000002200000001
1000002220001001
1000000222000001
1001100022000001
1001100220010001
1000002200000001
1000022222220008
1000000222222208
1000000020000001
1001100000000001
1000000220000001
1000000020100001
1000020000000001
1000000000000001
1111111111111111
