1111111771111111
1.....222......1
1..1...222.....1
1......22......1
1.....222......1
1....22........1
1..2222....1...1
02222.....1....1
022............1
1.......1......1
1..............1
1...1....1.....1
1..............1
1......1.......1
1..............1
1111111111111111
