1111111001111111
1.......2......1
1..............1
1......2.......1
1..............1
1.....2........1
1..............1
9...2...2.....21
9.2..........221
1.......2..2..21
1.....2........1
1.....2........1
1.....2........1
1......222222221
1111111111111111
